..#.....|
....#.###
#.##....#
#....##.#
..#.....#
.###.##..
.......#.
....#####
