.#......|
.#.####.#
.#.#..#.#
.#.#..#..
.#.#..#.#
.#.#..#..
...#..#.#
........#