.#..#...|
.#.#..#.#
.#....#..
...##..##
#.....#..
#.##....#
.....#...
...#.#.##
