.......#|
.######..
.#....#..
.#.####.#
.#......#
.#.###..#
......#.#
.####...#
