#.......|
#..#..###
#.##.####
...#....#
.#.####.#
##....#..
...###...
.#.....##
