#.......|
..#####.#
.....#...
##...#.##
##.###...
#....##.#
..###...#
......###
