..##....|
#.#..####
....#....
.##....#.
.#....#..
.#...#..#
....#....
...####..
