....#...|
#..####.#
......#.#
.#.##....
##..##..#
.#..##...
...#....#
.#...#...
