........|
####..#..
...#..#.#
..###...#
...###.##
.#...#...
.....#.##
...#....#
