##......|
#..####.#
#.#####..
..###.#.#
.###..#.#
.##..#..#
.#.....##
....##..#
